CHI = "countries/southeast/Chifengimperium.txt"
DOG = "countries/southeast/Dongfang.txt"
DRC = "countries/southeast/DexRegnum Continental Army.txt"
DVE = "countries/southeast/Dwarven Empire.txt"
EPC = "countries/southeast/Emperors Colonies.txt"
EPY = "countries/southeast/Emperors Empyrean.txt"
FDL = "countries/southeast/Fascist Directorate of the Liming.txt"
FGJ = "countries/southeast/Fenghuang Junta.txt"
FUL = "countries/southeast/Fulguribeng.txt"
HUV = "countries/southeast/Huovictor.txt"
ICU = "countries/southeast/Ignischuan.txt"
IWE = "countries/southeast/Igniswei.txt"
LCF = "countries/southeast/Liming Confedercy.txt"
LCS = "countries/southeast/Liming Custodianship.txt"
LMC = "countries/southeast/Liming Mercenary Company.txt"
LMN = "countries/southeast/Heavenly Kingdom.txt"
LPR = "countries/southeast/Peoples Republic.txt"
MYU = "countries/southeast/Monsyu.txt"
NEC = "countries/southeast/North-Eastern.txt"
NRS = "countries/southeast/North Regnum State.txt"
ODS = "countries/southeast/Outer Dwarven State.txt"
RDN = "countries/southeast/Reminisce of the Dwarven Navy.txt"
RPG = "countries/southeast/Republic of the Golf.txt"
RPT = "countries/southeast/Regnum Patriarchy.txt"
RUC = "countries/southeast/Rucognitio.txt"
SAG = "countries/southeast/Saga.txt"
SHE = "countries/southeast/Shengplana.txt"
SHU = "countries/southeast/Shuibellum.txt"
SIH = "countries/southeast/Sihuovictus.txt"
SSJ = "countries/southeast/State of the Supreme Junta.txt"
TRF = "countries/southeast/Terrafang.txt"
VEN = "countries/southeast/Ventianzheng.txt"
VIT = "countries/southeast/Vitanirvana.txt"
WYK = "countries/southeast/Wuye Kingdom.txt"
XIF = "countries/southeast/Xifang.txt"
# A B C D E F G H I J K L M N O P Q R S T U V W X Y Z