AVE	= "countries/upper/Alveare.txt"
BIU	= "countries/upper/Biusteti.txt"
CPV = "countries/upper/Commun of Primis Valley.txt"
DOC = "countries/upper/Dwarf Outer Colonies.txt"
DMP = "countries/upper/Domain of the Mid-Plains.txt"
ERP = "countries/upper/Elven Republica.txt"
ETF = "countries/upper/Elven Tribes Forces.txt"
FIK = "countries/upper/Frigidi Kingdom.txt"
GSD = "countries/upper/Gold Sursum Dwarf.txt"
HPV = "countries/upper/Harmonainus Providence.txt"
IHS = "countries/upper/Imperial Harmonainus State.txt"
KGK = "countries/upper/Kingdom of the Knights.txt"
LEE = "countries/upper/Leemays Kingdom.txt"
LRO = "countries/upper/Principality of Larion.txt"
MRC = "countries/upper/Merchant-Republica.txt"
	MAI = "countries/upper/Merchant-Republica.txt" # Aquilonoas Country
	MOI = "countries/upper/Merchant-Republica.txt" # Orientoas Country
	MPI = "countries/upper/Merchant-Republica.txt" # Potentoas Country
	MTI = "countries/upper/Merchant-Republica.txt" # Temerarium Country
NMR = "countries/upper/Necromage Regna.txt"
NRP = "countries/upper/Nova Republica.txt"
PCS = "countries/upper/Pullus Crusader State.txt"
REP = "countries/upper/The Republica.txt"
RVV = "countries/upper/Ravens Valley.txt"
SEK = "countries/upper/Sursum Elven Kingdom.txt"
SFG = "countries/upper/Sursum Free Governance.txt"
SLA = "countries/upper/Sursum Liberation Army.txt"
SMK = "countries/upper/South Slither Mountain Kingdom.txt"
SRA = "countries/upper/Sursum Revolutionary Army.txt"
SSD = "countries/upper/Silver Sursum Dwarf.txt"
UFS = "countries/upper/United Federal States.txt"
WIE = "countries/upper/Barony of Wievelka.txt"
# A B C D E F G H I J K L M N O P Q R S T U V W X Y Z